#############################
#                           #
#                           #
#                           #
#                           #
#      OWX                  #
#       WW                  #
#       WW                  #
#                           #
#                           #
#                           #
#                           #
#                           #
#############################
