#############################
#                           #
#                           #
#                           #
#                           #
#      OWX                  #
#       W                   #
#                           #
#                           #
#                           #
#                           #
#                           #
#                           #
#############################
