#############################
#                           #
#                           #
#                           #
#                           #
#                           #
#                           #
#       X                   #
#                           #
#                           #
#                           #
#                           #
#                           #
#############################
