#############################
#                           #
#                           #
#                           #
#                         X #
#      O                    #
#                           #
#                           #
#                           #
#                           #
#      W                    #
#                           #
#                           #
#############################
