        ######## 
        #     X# 
        # W#W ## 
        # W  W#  
        ##W W #  
######### W # ###
#OOOO  ## W  W  #
##OOO    W  W   #
#OOOO  ##########
########