          #######
          #  OOO#
      #####  OOO#
      #      OOO#
      #  ##  OOO#
      ## ##  OOO#
     ### ########
     # WWW ##    
 #####  W W #####
##   #W W   #   #
#X W  W    W  W #
###### WW W #####
     # W    #    
     #### ###    
        #  #     
        #  #     
        #  #     
        ####   