############  
#OO  #     ###
#OO  # W  W  #
#OO  #W####  #
#OO    X ##  #
#OO  # #  W ##
###### ##W W #
  # W  W W W #
  #    #     #
  ############