    #####             
    #   #             
    #W  #             
  ###  W###           
  #  W  W #           
### # ### #     ######
#   # ### #######  OO#
# W  W             OO#
##### #### #X####  OO#
    #      ###  ######
    ########