######  ### 
#OO  # ##X##
#OO  ###   #
#OO     WW #
#OO  # # W #
#OO### # W #
#### W #W  #
   #  W# W #
   # W  W  #
   #  ##   #
   #########