        #####    
        #   #####
        # #W##  #
        #     W #
######### ###   #
#OOOO  ## W  W###
#OOOO    W WW ## 
#OOOO  ##W  W X# 
#########  W  ## 
        # W W  # 
        ### ## # 
          #    # 
          ###### 