       ##### 
 #######   ##
## # X## WW #
#    W      #
#  W  ###   #
### #####W###
# W  ### OO# 
# W W W OOO# 
#    ###OOO# 
# WW # #OOO# 
#  ### ##### 
####         